0   1   1   1   1   1   1   1   1   1   1   1   1   1   1   2
3  -1  -1  -1  -1  -1  -1  41  -1  -1  41  -1  -1  -1  -1  11
3  43  -1  -1  -1  -1  -1  40  -1 100  40  -1  -1  -1  -1  39
3   6  -1  -1  -1  -1  -1   9   9   9   9  -1  -1   5   6   7
3  -1  -1  -1  -1  -1  -1  -1  -1  -1  -1  -1  -1  -1  -1   4
3  -1  -1  -1  -1  -1  -1  -1  -1  -1  -1  -1  -1  -1  -1   4
3  -1  -1  -1  -1  -1  -1  -1  -1  -1  -1  -1  -1  -1  -1   4
3  -1  -1   8  -1  10  -1  -1  -1  -1  -1  -1  -1  -1  42   4
3  -1   8   8  -1  10  50  -1  -1  -1  -1  -1  -1  -1  42   4
6   5   5   5   5   5   5   5   5   5   5   5   5   5   5   6

0   1   1   1   1  16   1   1  16  17  17  17  17   1   1   1   2
19 -1  -1  -1  -1  21 -1  57  15 -1  -1  -1  -1  -1  -1   4
39 -1  -1  -1  -1  21 100 -1  15 -1  -1  -1  -1  -1  -1   4
3  -1  -1  -1  -1 12 21 -1 15 -1 50 -1 -1 -1 -1   4
3  -1  -1  -1  -1 -1 -1 -1 12 13 13 13 14 -1 -1   4
3  -1  -1  -1  -1 -1 -1 -1 41 -1 -1 -1 41 -1 -1   4
3 45 -1 -1 -1 -1 -1 -1 41 -1 -1 -1 41 -1 -1   11
3 42 48 47 -1 -1 -1 -1 41 -1 -1 -1 41 -1 -1   39
3 42 8 49 -1 -1 -1 51 40 -1 45 -1 41 -1 -1   4
6   5   5   5   5   5   5   5   5   5   5   5   5   5   5   6

0   1   1   1   1   1   1   1   1   1   1   1   1   1   1   2
3  -1  -1  -1  -1  -1  -1  -1  -1  -1  -1  -1  51  -1 100   4
3  50  -1  -1  43  44  -1  -1  -1  -1  -1  52  28  53  54   4
3  13  -1  16  17  17  -1  -1  -1  -1  28  28  28  28  28   4
3  -1  -1  21  -1  -1  -1  -1  -1  -1  28  -1  -1  -1  -1   4
19 -1  -1  -1  -1  -1  -1  -1  -1  -1  -1  -1  -1  -1  -1   4
39 -1  -1  21  -1  -1  -1  -1  -1  -1  -1  -1  -1  -1  -1   4
3   9   20   21   42   48   -1   -1   -1   -1   -1   -1   -1   20   -1   11
3   20   9   6   42   43   -1   -1   -1   -1   -1   8   20   20   -1   39
6   5   5   5   5   5   5   5   5   5   5   5   5   5   5   6

0   1   1   1   1   1   1   1   1   1   1   1   1   1   1   2
3  -1  57  46  -1  -1  -1  46  47  -1  -1  -1  -1  56  55   8
3 100  -1  46  43  44  -1  46  58  59  60  -1  -1  -1  50   8
3  13  -1  46  13  13  13  46   9   9  13  -1  -1  13  13   8
3  -1  -1  46  -1  -1  -1  46  -1  -1  -1  -1  -1  -1  -1   8
19 -1  -1  46  -1  -1  -1  46  -1  -1  -1  -1  -1  -1  57   8
39 -1  -1  46  -1  -1  -1  46  -1  -1  -1  -1  -1  -1  -1   8
3   9   42  46  56  55  -1  46  -1  -1  -1  -1  -1  -1   -1  11
3  20   9   46  44  43   -1  46   -1  52  45  45  45   -1   -1  39
6  5   5   5   5   5   5   5   5   5   5   5   5   5   5   5   6

22 23 23 23 23 23 23 23 23 23 23 23 23 23 23 24
25 -1 -1 65 -1 -1 -1 -1 -1 -1 -1 -1 -1 -1 -1 26
25 -1 -1 65 43 44 -1 -1 -1 -1 28 -1 -1 64 -1 26
25 13 -1 65 28 28 28 -1  9  9 13 -1 -1 13 13 26
25 -1 -1 65 -1 -1 -1 -1 -1 -1 -1 -1 -1 -1 -1 26
19 -1 -1 65 -1 -1 -1 -1 -1 -1 -1 -1 -1 -1 57 26
39 -1 -1 65 -1 -1 61 -1 -1 -1 -1 -1 61 -1 -1 26
25  9 28 65 56 55 -1 -1 -1 -1 -1 -1 -1 -1 -1 11
25 28  9 65 64 64 -1 -1 -1 50 62 63 -1 -1 -1 39
27 27 27 27 27 27 27 27 27 27 27 27 27 27 27 27
